32
32
11111111111111111111111111111111
10011000111101111111011111010111
11001111100110001001001001011101
11100000000011101001001011010101
10101110110110101101011010010111
11000010100100100101110011010001
11011110111110100100011101011101
11010000000000110111000001000111
11010011111111010001111101110011
10001110000000011110000100011011
11101010101111100010111101001011
10101011101010000110001001101011
11101000011010111100011001001111
11001001110011100001110111000101
11101011000000000111000001011101
10101010111111101101101111010011
11111010001000100000100010010011
11010011101110111110101110110011
10011100110010000011100100100111
11110100011011011000011111111101
11000100001001110010010000000111
11110011101110011011110111100011
11010010100010101100001100101111
11010110111010100110111000101001
11011101100010100011101101101001
11000001011110100000000101001111
11010111000100111101110101100001
11110101101100100111011000111001
10100100001011111000001110101001
10110110111010000011100010001011
10010011100010111110000000000001
11111111111111111111111111111111
