16
12
111111111111
100000000001
100000000001
100000000001
100000000001
100000000001
101100000001
100100000001
100000000001
100000000001
101000000001
100000000001
100000000001
100000000001
100000000001
111111111111
